R0000000000000000000000000000000000000000000R
R0000000000000000000000000000000000000000000R
R0000000000000000000000000000000000000000000R
R00000000000000000000000000000000000000OO000R
R000000000000000000000BBBBBBBBBBB00000000000R
R000000000000000000000D0b00000b0D00000000000R
R0000000000BBBBBB000000000000000000000000000R
R00000000B000P0000B000000B0B0B00000000000000R
RBBBBBBBBDBBBBBBBBDBBBBBb00000bBBBBB00000000R
0000000R000000000O00000DBBBBBBBD000R0b000000R
000RRRRR000000000000000000000000000R00B00000R
000R000R000000000000O00000000000000Rb0000000R
000RCR0RRRR0RRR00000000000000000000R00000B00R
000R0Rb0000000R00000000000000000000R000b0000R
000R0RR0000000R00000000000000000000R00B00000R
000R0Rb0000000R00R00000000000000000R0000000bR
000RCRR0000000R00000000000000000000R00000B00R
000R0Rb0000000R00000R00000000000000Rb0000000R
000R0RR0000000R00000R00BBBBBBB00000000B00000R
000R0R00000000RSSSSSC00000000000000000000000R
000RCRRRRRRRRRRRRRRRR00000000000BBBBSSS00SSSR
000R000000000000000RR0d0d0J0d0d0D00RRRRRRRRRR
000R0d000d00d0000d00RBBBBBBBBBBBD000000000000
000RRRRRRRRRRRRRRR000RR0000000000000000000000
00000000000000000RRd00RR000000000000000000000
000000000000000000RR000RR000000000RRRRR000000
0000000000000000000RRd00RRRRRRRRRRR000R000000
00000000000000000000RR00000000000000B0R000000
000000000000000000000RR00d00000d000dD0R000000
0000000000000000000000RBBBBBBBBBBBBBD0R000000
000000000000000000000000000000000000R0R000000
000000000000000000000000000000000000R0R000000
000000000000000000000000000000000000R0R000000
000000000000000000000000000000000000R0R000000
000000000000000000000000000000000000R0R000000
000000000000000000000000000000000000R0R000000
0000000000000000000000RRRRRRRRRRRRRRR0RRRRRR0
0000000000000000000000R00000000000000000000R0
0000000000000000000000R00000000000000000000R0
0000000000000000000000R00000000000000000000R0
0000000000000000000000R00000000!00000000000R0
0000000000000000000000R0S0000000S000000000SR0
0000000000000000000000RBB00BBBBBBBBBB00BBBRR0
0000000000000000000000RDDD00DD0000DDDBBDDD000
0000000000000000000000000RRRR0000000RRRR00000
000000000000000000000000000000000000000000000