D00000000000000000000000000000000000000000000D000000D0000000000000000000000000000000000000000000
D00000000000000000000000000000000000000000000000000000000000000000000000000000000000000000000000
D00000000000000000000000000000000000000000000000000000000000000000000000000000000000000000000000
D00000000000000000000000000000000000000000000000000000000000000000000000000000000000000000000000
D0000000000000000000000000000000000000000000000D000000000000000000000000000000000000000000000000
D000000000000000000000000000000000000000M000D000000000000000000000000000000000000000000000000000
D000000000000000000000000000000000000000D0000000D0000000000000000000000000000000000S0S0000000000
D00000000000000000000000000000000000000000000000000D00000000000000000D0000000000000D0D0000000000
D000000000000000000000000000B0000000000000000a000000aD000000000000D00000D00000M00000000000000000
D00000000000000000000000000BD00000000000000DDDDDDDDDDDDDD000000000000000000DDDDDDD00000000000000
DP000000B00000000000000000BDD000000000000000000000000000000D0000000D0000000D00000D00000000000000
DBBBBBBBD00BBB00c00000cBBBDDD000000000000000a00a00a000a00D0000D00D000000000D00000Dca0acB00000000
DDDDDDDDDSSDDDBBBBBBBBBDDDDDDBSSSBBBBBBBBBBBBBBBBBBBBBBBBSSSSSSSSSSSSSSSSSSD00000DBBBBBDB00R0000
000000000DD0000000000000000000DDD000000000000000000000000DDDDDDDDDDDDDDDDDDD000000000000DB0R0000
0000000000000000000000000000000000000000000000000000000000000000000000000000000000000RRRR00R0000
0000000000000000000000000000000000000000000000000000000000000IIIIIIIIIIIIIIIIIIIIIIIIR000MRRIIII
0000000000000000000000000000000000000000000000000000000000000I00000000000000000000000RIIIRR0000I
0000000000000000000000000000000000000000000000000000000000000I0000000000000000000000RR0SRR00000I
0000000000000000000000000000000000000000000000000000000000000I000RRRRRRRRRRRRRRRRRRRRR0RRRRR000I
0000000000000000000000000000000000000000000000000000000000000I000R0000@0000000000@000000000R000I
0000000000000000000000000000000000000000000000000000000000000I000R0000000000000000000000000R000I
0000000000000000000000000000000000000000000000000000000000000I000R0000000000000000000000000R000I
0000000000000000000000000000000000000000000000000000000000000I000R000000000000000000000@000R000I
0000000000000000000000000000000000000000000000000000000000000I000R00000000000000000@0000000R000I
0000000000000000000000000000000000000000000000000000000000000I000R0000000000000000000000000R000I
0000000000000000000000000000000000000000000000000000000000000I000R0000000000000000000000000R000I
0000000000000000000000000000000000000000000000000000000000000I000RSRRRRRSRRRRRSRRRRRSRRRRRSR000I
0000000000000000000000000000000000000000000000000000000000000I000RRR000RRR000RRR000RRR000RRR000I
0000000000000000000000000000000000000000000000000000000000000I000000000000000000000000000000000I
0000000000000000000000000000000000000000000000000000000000000I000000000000000000000000000000000I
0000000000000000000000000000000000000000000000000000000000000I000000000000000000000000000000000I
0000000000000000000000000000000000000000000000000000000000000IIIIIIIIIIIIIIIIIIIIIIIIIIIIIIIIIII