RRRRRRRRRRRRRRRRRRRRRRRRRRRRRRRRRRRRRRRRRRRRR
R0000000000000000000000O00000000000000000000R
R0000000000000000000000000000000000000000000R
R0000000000000000000000000000000000000000000R
R00000000000000000000000?0000000000000000000R
R0000000B000B00000000?BBB0000000000000000000R
RP0?B0?JD?G?DSSSSS00BBDDDB?00cB?A0?M0?W00?00R
DBBBDBBBDBBBDBBBBBBBDDDDDDBBBBDBBBBBBBBBBBBBD