RRRRRRRRRRRRRRRRRRRRRRRRRRRRRRRRRRRRRRRRRRRR
R0000000000000000000000O0000000000000000000R
R000000000000000000000000000000000000000000R
R000000000000000000000000000000000000000000R
R00000000000000000000000?000000000000000000R
R0000000B000B00000000?BBB000000000000000000R
RP0?B0?JD?G?DSSSSS00BBDDD?00cB?A0?M0?W00000R
DBBBDBBBDBBBDBBBBBBBDDDDDBBBBDBBBBBBBBBBBBBD
