RRRRRRRRRRRRRRRRRRRRRRRRRRRR
R00000000000000000000000000R
R00000000000000000000000000R
R000000000P000000000!000000R
R00000000000000000000000000R
R00000000000000000000000000R
R00000000000000000000000000R
R00000000000000000000000000R
RRRRRRRRRRRRRRRRRRRRRRRRRRRR
