LLLLLLLLLLLLLLLLLLLLLLLLLLLL
L00000000000000000000000000L
L00000000000000000000000000L
L0000000000000P000000000000L
L000LL00000000L000000000000L
L0000000000000L000000000000L
LLLLLLLLLLLLLLLLLLLLLLLLLLLL