RRRRRRRRRRRRRRR0000000000000000
R000000P000000R0000000000000000
R000000R000000R0RRRRRRRRRRRRRRR
R0000000000000RRR0000000000000R
R000R00000R0000000000000000000R
R00c00C0C00c00RRR0000000000000R
RRRRRRRRRRRRRRR0R0000000000000R
0000000000000000R0000000000000R
0000000000000000RRRRRRRRRRRRRRR
