R0000000000000000000000000000000000000000000R
R0000000000000000000000000000000000000000000R
R0000000000000000000000000000000000000000000R
R00000000000000000000000000000000000000OO000R
R000000000000000000000BBBBBBBBBBB00000000000R
R000000000000000000000B0b00000b0B00000000000R
R0000000000BBBBBB000000000000000000000000000R
R00000000B00000000B000000B0B0B00000000000000R
RBBBBBBBBBBBBBBBBBBBBBBBb00000bBBBBB00000000R
0000000R000000000O00000BBBBBBBBB000R0b000000R
0000000R000000000000000000000000000R00B00000R
0000000R0000P0000000O00000000000000Rb0000000R
00000RRRRRR0RRR00000000000000000000R00000B00R
00000Rd0000000R00000000000000000000R000b0000R
00000RR0000000R00000000000000000000R00B00000R
00000Rd0000000R00R00000000000000000R0000000bR
00000RR0000000R00000000000000000000R00000B00R
00000Rd0000000R00000R00000000000000Rb0000000R
00000RR0000000R00000R00BBBBBBB00000000B00000R
00000R00000000RSSSSSR00000000000000000000000R
00000RRRRRRRRRRRRRRRR00000000000BBBBSSS00SSSR
00000000000000000000R0d0d0J0d0d0B00RRRRRRRRRR
00000000000000000000RBBBBBBBBBBBB000000000000