RRRRRRRRRRRRRRRRRRRRRRRRRRRR
R00000000O0O000000000000000R
R00000000000000000000000000R
R000000000P0000000000000000R
RRabcdefRRRRR0000000WJMAG00R
RBBBBBBBBBBRRRSSSSRRLLLLLLLR
RRRRRRRRRRRRRRRRRRRRRRRRRRRR