RRRRRRRRRRRRRRRRRRRRRRRRRRRRRR
RRRRRRRRRRRRRRRRRRRRRRRRRRRRRR
RR00000000000000000000000000RR
RR00000000000000000000000000RR
RR000000000P0000!00000000000RR
RR00000000000000000000000000RR
RR00000000000000000000000000RR
RR00000000000000000000000000RR
RR00000000000000000000000000RR
RRRRRRRRRRRRRRRRRRRRRRRRRRRRRR
RRRRRRRRRRRRRRRRRRRRRRRRRRRRRR
