D0000000000000000000000000000000000000000000000000000000000000000000000000000000000000000000
D0000000000000000000000000000000000000000000000000000000000000000000000000000000000S0S000000
D00000000000000000000000000000000000000000000000000000000000000000000D0000000000000D0D000000
D000000000000000000000000000B0000000000000000000000000000000000000D00000D00000M0000000000000
D00000000000000000000000000BD00000000000000DDDDDDDDDDDDDD000000000000000000DDDDDDD0000000000
DP000000B00000000000000000BDD000000000000000000000000000000D0000000D0000000000000D0000000000
DBBBBBBBD00BBB00c00000cBBBDDD000000000000000a00a00a000a00D0000D00D000000000000000Dca0acB0000
DDDDDDDDDSSDDDBBBBBBBBBDDDDDDBSSSBBBBBBBBBBBBBBBBBBBBBBBBSSSSSSSSSSSSSSSSSSSSS000DBBBBBDB00R
000000000DD0000000000000000000DDD000000000000000000000000DDDDDDDDDDDDDDDDDDDDD0000000000DB0R
00000000000000000000000000000000000000000000000000000000000000000000000000000000000000RRR00R
0000000000000000000000000000000000000000000000000000000000000000000000000000000000000RR000RR
0000000000000000000000000000000000000000000000000000000000000000000000000000000000000R000RR0
000000000000000000000000000000000000000000000000000000000000000000000000000000000000RR0SRR00
00000000000000000000000000000000000000000000000000000000000000000RRRRRRRRRRRRRRRRRRRR00RRRRR
00000000000000000000000000000000000000000000000000000000000000000R0000@000000000@0000000000R
00000000000000000000000000000000000000000000000000000000000000000R0000000000000000000000000R
00000000000000000000000000000000000000000000000000000000000000000R0000000000000000000000000R
00000000000000000000000000000000000000000000000000000000000000000R000000000000000000000@000R
00000000000000000000000000000000000000000000000000000000000000000R0000000000000000@00000000R
00000000000000000000000000000000000000000000000000000000000000000R0000000000000000000000000R
00000000000000000000000000000000000000000000000000000000000000000R0000000000000000000000000R
00000000000000000000000000000000000000000000000000000000000000000RSSRRRRRRRRRSRRRRRRSSRRRRRR
00000000000000000000000000000000000000000000000000000000000000000RRRRR000000RRR000RRRRRR0000