R
R
R
R
R
R
R
R
R
R
R
R
R
R
R
R
R
R
R
R
R
R
R
R
R
R
R
R
R
R
R
R
R
R
R
R
R
R
R
R
R
R
R
R
R
R
R
R
R
R
R
R
R
R
R
R00R
R00000000000000000000000000000
RR
R00000000000000000000000000000
RRRR00000000R00000000000R00000
R000ee000ee000ee000ee000RR0000
RRRRRRRRRRRRRRRRRRRRRRRRRRR000
R00000000000000000000000000000
R000000000000000000000RR0000RR
R000a000a000a000a0000000000000
RRRRCRRRCRRRCRRRCRRR0000000000
R00000000000000000000000000000
RRRRRRRRRRRRRRRRRRRRRRR0000000
RRRRRRRRR000000000000000000000
RRRR0000000000000000000000R000
R00000000000000000000R0000R000
R000000000000000R0000R00000000
R0000000000R0000R0000000000000
R00000R0000R000000000000000000
RR0000R00000000000000000000000
RRR000000000000000000000000000
RRRRR0000000000000000000000000
R000RRRRRRRRRRRRRRRRRRRR000000
R0P0CCCC0000f0000f0000f0000R00
RRRRRRRRRRRRRRRRRRRRRRRRRRRR00
