D000000000000000000000000000000000000000000000000000000000000000000000000000000000000000
D00000000000000000000000000000J0000000000000000000000000000000000000000000000000000S0S00
D00000000000000000000000000000000000000000000000000000000000000000000D0000000000000D0D00
D000000000000000000000000000B0000000000000000000000000000000000000D00000D00000M000000000
D00000000000000000000000000BD00000000000000DDDDDDDDDDDDDD000000000000000000DDDDDDD000000
DP000000B00000000000000000BDD000000000000000000000000000000D0000000D0000000000000D000000
DBBBBBBBD00BBB00c00000cBBBDDD000000000000000a00a00a000a00D0000D00D000000000000000Dca0acD
DDDDDDDDDSSDDDBBBBBBBBBDDDDDDBSSSBBBBBBBBBBBBBBBBBBBBBBBBSSSSSSSSSSSSSSSSSSSSS000DBBBBBD
000000000DD0000000000000000000DDD000000000000000000000000DDDDDDDDDDDDDDDDDDDDD0000000000