RRRRRRRRRRRRRRRRRRRRRRRRRRRR
R00000@00000000000000000000R
R00000000000WWW000000000000R
R000000000P0WWW000000000000R
RRabcdefCCRRRWWWW000WJMAG00R
RBBBBBBBBBBRRRSSSSRRLLLLLLLR
RRRRRRRRRRRRRRRRRRRRRRRRRRRR