RRRRRRRRRRRRRRRRRRRRRRRRRRRRRR
RRRRRRRRRRRRRRRRRRRRRRRRRRRRRR
RR00000000000000000000000000RR
RR00000000000000000000000000RR
RR000000000P0000!00000000000RR
RR00000000000000000000000000RR
RR00000000000000000000000000RR
RR000000000JG000000000000000RR
RR0000000WWWWWWWWWWWWW000000RR
RRRRR0d00RRRRRRRRRRRRRRRRRRRRR
RRRRRRRRRRRRRRRRRRRRRRRRRRRRRR
