CCCCCCCCCCCCCCCCCCCCCCCCCCCC
C00000000000000000000000000C
C00000000000000000000000000C
C000000000P0000000000000000C
CCabcdefCCCCC00000000JMAG00C
CBBBBBBBBBBCCCSSSSCCLLLLLLLC
CCCCCCCCCCCCCCCCCCCCCCCCCCCC
