LLLLLLLLLLLLLLLLLLLLLLLLLLLL
L00000000000000000000000000L
L0000A0J0000000000LLL000000L
L000L000000000P000000000000L
L000LL00000M00L000LLL000000L
L000LLL0000000L00L000000000L
LLLLLLLLLLLLLLLLLLLLLLLLLLLL