000000000000000000000000000000R0
000000000000000000000000000000R0
000000000000000000000000000000R0
000000000000000000000000000000R0
RRRRRRRRRRRRRRRRR000000000000000
RR000000I000000RR000000000000000
RS0000000000000SR000000000000000
RR0000000000000RR000000000000000
R000000000000000R000000000000000
R00000R000R00000R000000000000000
RR0000000000000RR000000000000000
R00#000000000000R000000000000000
RR00000000000JGRR000000000000000
RRSRSRSSRSSRSRSRR000000000000000
RRRRRRRRRRRRRRR00000000000000000
00000000000000000000000000000000
00000000000000000000000000000000
00000000000000000000000000000000
00000000000000000000000000000000
R0000000000000000000000000000000
R00000000000000000000000000000RR
R0000000000000000000000000000a00
R0000000000000000000000000000RR0
R000000000000000000000000000000a
R00000000000000000000000000000RR
R0000000000000000000000000000aR0
R0000RRRRRRRRRR0000R0000R0000RR0
R0000000000000000000000000000000
R00R0000000000000000000000000000
R0000000000000000000000000000000
RR000000000000000000000000000000
R0000000000000000000000000000000
R00R0000000000000000000000000000
R0000000000000000000000000000000
RR000000000000000000000000000000
R0000000000000000000000000000000
RRRR00000000R00000000000R0000000
RRRRee000ee000ee000ee000RR000000
RRRRRRRRRRRRRRRRRRRRRRRRRRR00000
R0000000000000000000000000000000
R000000000000000000000RRR0000R00
R00RaRSRaRSRaRSRaRJGR0000000R000
RCRRCRRRCRRRCRRRCRRR000000000000
R00000000000000000000000R0000000
RRRRRRRRRRRRRRRRRRRRRR00000R0000
RRRRRRRRR00000000000000000000000
RRRR0000000000000000000000R00000
R00000000000000000000R0000R00000
R000000000000000R0000R0000000000
R0000000000R0000R000000000000000
R00000R0000R00000000000000000000
RR000000000000000000000000000000
RRR00000000000000000000000000000
RRRRRRLLLLLRLLLLLRLLLLLR00000000
R000RRRRRRRRRRRRRRRRRRRR00000000
R0P0CCCCJG00f0000f0000f000R00000
RRRRRRRRRRRRRRRRRRRRRRRRRRR00000
00000000000000000000000000000000
00000000000000000000000000000000
00000000000000000000000000000000
00000000000000000000000000000000
00000000000000000000000000000000
00000000000000000000000000000000
00000000000000000000000000000000
R0000000000000000000000000000000
R0000000000000000000000000000000
RLLLLLLLLLLLLLLLLLLLLLLLLLLLLLLL
RRRRRRRRRRRRRRRRRRRRRRRRRRRRRRRR
