RRRRRRRRRRRRRRRRRRRRRRRRRRRR
R00000000O0O000000000000000R
R00000000000000000000000000R
R000000000P0000000000000000R
RRabcdefCCR0R0000000WJMAG00R
RBBBBBBBBBB0RRSSSSRRLLLLLLLR
RRRRRRRRRRR0RRRRRRRRRRRRRRRR
R00000000000000000000000000R
R00000000000000000000000000R
R00000000000000000000000000R
R00000000000000000000000000R
R00000000000000000000000000R
R00000000000000000000000000R
R0000!000000000000000000000R
R00000000000000000000000000R
RRRRRRRRRRRRRRRRRRRRRRRRRRRR