R0000000000000000000000000000000
R0000000000000000000000000000000
R0000000000000000000000000000000
R0000000000000000000000000000000
R00000000000000000000BBBBBBBBBBB
R00000000000000000000B0b00000b0B
R0000000000BBBBBB000000000000000
R00000000B00000000B0P000B0B0B000
RBBBBBBBBBBBBBBBBBBBBBBb00000bBB
0000000000000000000000BBBBBBBBB0