R00000000000000000000000000000
R00000000000000000000000000000
R00000000000000000000000000000
R00000000000000000000000000000
R00000000000000000000000000000
R00000000000000000000000000000
R00R00000000000000000000000000
R00000000000000000000000000000
RR0000000000000000000000000000
R00000000000000000000000000000
R00000000000000000000000000000
R00000000000000000000000000000
R00000000000000000000000000000
R00000000000000000000000000000
R00000000000000000000000000000
R00000000000000000000000000000
R00R00000000000000000000000000
R00000000000000000000000000000
RR0000000000000000000000000000
R00000000000000000000000000000
RRRR00000000R00000000000R00000
R000ee000ee000ee000ee000RR0000
RRRRRRRRRRRRRRRRRRRRRRRRRRR000
R0000000000000000000000P000000
R000000000000000000000RRR0000R
R00RaRSRaRSRaRSRaRJGR0000000R0
RCRRCRRRCRRRCRRRCRRR0000000000
R00000000000000000000000R00000
RRRRRRRRRRRRRRRRRRRRRR00000R00
RRRRRRRRR000000000000000000000
RRRR0000000000000000000000R000
R00000000000000000000R0000R000
R000000000000000R0000R00000000
R0000000000R0000R0000000000000
R00000R0000R000000000000000000
RR0000R00000000000000000000000
RRR000000000000000000000000000
RRRRR000000000000000000R000000
R000RRRRRRRRRRRRRRRRRRRR000000
R000CCCCJG00f0000f0000f000R000
RRRRRRRRRRRRRRRRRRRRRRRRRRR000
