____________________________________RRRRRR________________________________________R_
____________________________________R_____________________________________________R_
____________________________________RCCRRR________________________________________R_
____________________________________RCCR______R___________________________________R_
____________________________________RCCR__________________________________________R_
____________________________________RCCR________________R_________________________R_
____________________________________RCCR_____________________________WW__S_S__WW__R_
__________________________________RRRCCRRR________________________RRRRRRRR_RRRRRRRR_
__________________________________Rc_____R________________________RR______I______RR_
__________________________________RRRCCRRR________________________RS_____________SR_
____________________________________RCCR__________________________RR_____________RR_
____________________________________RCCR__________________________R_______________R_
____________________________________RCCR__________________________R_____R___R_____R_
____________________________________RCCR__________________________RR_____________RR_
__________________________________RRRCCRRR________________________R__#____________R_
__________________________________Rc_____R________________________RR_____________RR_
__________________________________RRRCCRRR________________________RRSRSRSSRSSRSRSRR_
____________________________________RCCR___________________________RRRRRRRRRRRRRRR__
____________________________________RCCR____________________________________________
____________________________________RCCR____________________________________________
____________________________________RCCR____________________________________________
_____________________________RRRRRRRRCCR____________________________________________
R______________________________________R____________________________________________
R_____________________________RRRRRRRRRR____________________________________________
R____________________________a______________________________________________________
R____________________________RR____________________________________________________R
R______________________________a___________________________________________________R
R_____________________________RR___________________________________________________R
R____________________________aR____________________________________________________R
R____RRRRRRRRRR____R____R____RR____________________________________________________R
R__________________________________________________________________________________R
R__R_______________________________________________________________________________R
R__________________________________________________________________________________R
RR_________________________________________________________________________________R
R__________________________________________________________________________________R
R__R_______________________________________________________________________________R
R__________________________________________________________________________________R
RR_________________________________________________________________________________R
R__________________________________________________________________________________R
RRRR____________________R__________________________________________________________R
RRRRee___ee_R_ee__Ree___RR_________________________________________________________R
RRRRRRRRRRRRRRRRRRRRRRRRRRR________________________________________________________R
R__________________________________________________________________________________R
R_____________________RRR____R_____________________________________________________R
R__RaRSRaRSRaRSRaRSRR_______R______________________________________________________R
RCRRCRRRCRRRCRRRCRRR_______________________________________________________________R
R_______________________R__________________________________________________________R
RRRRRRRRRRRRRRRRRRRRRR_____R_______________________________________________________R
RRRRRRRRR__________________________________________________________________________R
RRRR______________________R________________________________________________________R
R____________________R____R________________________________________________________R
R_______________R____R_____________________________________________________________R
R__________R____R__________________________________________________________________R
R_____R____R_______________________________________________________________________R
RR_________________________________________________________________________________R
RRR________________________________________________________________________________R
RRRRRRLLLLLRLLLLLRLLLLLR___________________________________________________________R
R___RRRRRRRRRRRRRRRRRRRR___________________________________________________________R
R_P_CCCCJG__f____f____f___R________________________________________________________R
RRRRRRRRRRRRRRRRRRRRRRRRRRR________________________________________________________R
___________________________________________________________________________________R
___________________________________________________________________________________R
___________________________________________________________________________________R
___________________________________________________________________________________R
___________________________________________________________________________________R
___________________________________________________________________________________R
___________________________________________________________________________________R
R__________________________________________________________________________________R
R__________________________________________________________________________________R
RLLLLLLLLLLLLLLLLLLLLLLLLLLLLLLLLLLLLLLLLLLLLLLLLLLLLLLLLLLLLLLLLLLLLLLLLLLLLLLLLLLR
RRRRRRRRRRRRRRRRRRRRRRRRRRRRRRRRRRRRRRRRRRRRRRRRRRRRRRRRRRRRRRRRRRRRRRRRRRRRRRRRRRRR