RRRRRRRRRRRRRRRRRRRRRRRRRRRR
R00000000O00000000000000000R
R00000000000000000000000000R
R000000000P0W0W000000000000R
RRabcdefCCRRR0000000WJMAG00R
RBBBBBBBBBBRRRSSSSRRLLLLLLLR
RRRRRRRRRRRRRRRRRRRRRRRRRRRR