LLLLLLLLLLLLLLLLLLLLLLLLLLLL
L00000000000000000000000000L
L0000A0J0000000000LLL000000L
L000L000000000P000000000000L
L000LL00G00M00C000LLL000000L
L000LLL000SSS0C0EL0abcdef00L
BBBBBBBBBBBBBBBBBBBBBBBBBBBB
